adage: adage
advertising: advertising
age: age
alexa: alexa
anythingbutcute: anythingbutcute
beth: beth
com: com
communications: communications
crain: crain
culture: culture
deadmanchest: deadmanchest
element: element
honda: honda
inc: inc
june: june
man: man
marketing: marketing
motorola: motorola
moves: moves
myspace: myspace
new: new
online: online
phone: phone
secret: secret
snyderbulik: snyderbulik
space: space
times: times
url: url
victoria: victoria
vspink: vspink
watching: watching
www: www
york: york
автор: автор
аккаунт: аккаунт, аккаунты
аудитоия: аудитоий
аудитория: аудитории
бесплатный: бесплатный
бизнес: бизнеса
блогер: блоггеры
больший: большую
важный: важную
весь: всем
взрослеть: взрослеет
взрослый: взрослых
владелец: владельцы
вместо: вместо
вообще: вообще
вывод: вывод
вылезать: вылезают
выпускать: выпускает
высокий: высокая
газета: газет, газетой
говорить: говорит
год: года, лет
данные: данным
двадцать: двадцати
девяностый: девяностые
делать: делает
дизайнер: дизайнеры
директор: директора
доля: доля
доступ: доступ
другой: другие, другим, других
жаждать: жаждущие
заключать: заключает
занимать: занимает
запоздалый: запоздалые
затрагивать: затрагивают
знание: знаниям
издание: издание
иначе: иначе
интерес: интересам
интернет: интернет
исследование: исследованиями
июль: июля
какой: какую
кампания: кампании
кастинг: кастинги
клуб: клубов
количество: количество
коммуникация: коммуникаций
компания: компании
консалтинговый: консалтинговые
который: которая, которые, которым
мyspace: мyspace
маркетинг: маркетинг
маркетинговый: маркетинговых
мелкий: мелкого
место: место
миллион: миллиона
молодой: молодыми
молодёжный: молодежной, молодежных
монстр: монстр
море: моря
муspace: муspace
музыкальный: музыкальные
наравне: наравне
наугад: наугад
неизбежный: неизбежном
необходимый: необходимым
номер: номера
обзор: обзор
общение: общения
одновременно: одновременно
оказываться: оказывается
основное: основном
отобрать: отобранных
отставать: отставать
переводить: переводить
печатать: печатали
пират: пиратов
планета: планете, планеты
поведение: поведения
подросток: подростки
поздний: поздние
пользователь: пользователей, пользователи
пользоваться: пользуются
посредством: посредством
потребительский: потребительского
почему: почему
предложить: предложить
пресса: прессы
привлекать: привлекает
приводить: приводит
приготовиться: приготовьтесь
пример: примере, примеры
продвигать: продвигают
продукт: продукте
продюсер: продюсеры
промоутировать: промоутируя
пять: пяти
реклама: рекламе, рекламы
ресторан: ресторанов
решить: решил
рука: руках
рэнс: рэнса
сайт: сайта, сайтов
самовыражение: самовыражения
свой: свои
сериал: сериалов
сеть: сетей, сети, сетями
сиквел: сиквела
скоро: скоро
скрупулёзно: скрупулезно
следствие: следствие
смежный: смежным
собственный: собственного
создавать: создают
социализироваться: социализирующиеся
социальный: социальные, социальными, социальных
специалист: специалисты
среди: среди
старший: старше
стать: станет, статей
статья: статьи, статью
сфера: сферам
счёт: счет
таргетированность: таргетированность
телевизионный: телевизионные
тема: тему
тинэйджер: тинэйджерами
тот: тех
тред: треде
тренд: тренда, трендов
тридцать: тридцати
туда: туда
упаковка: упаковке
услуга: услуги
успешно: успешно
устраивать: устраивают
френд: френдами, френдов
художник: художники
частый: частые
человек: людей, люди
шестой: шестое
шутка: шутка
эффективность: эффективности
