categorizer: categorizer
блог: блог, блога
брендинг: брендинг
быть: буду, будут
вдали: вдали
весь: всем
взгляд: взглядов
год: год
группа: группу, группы
ждать: ждите
заинтересовать: заинтересовать
зайти: зайти
заходить: заходят
захотеть: захотел
знать: знал
идея: идею
иметь: имеет
интересно: интересно
интересный: интересна, интересны
интернет: интернете
инф: инфу
конец: конца
который: которые
кто: кому
линк: линки
многий: многим
мочь: могут
никто: никто
новость: новостей, новость
нужно: нужно
обсудить: обсудить
общий: общего, общем
один: одну
осознать: осознал
отличаться: отличаются
отлично: отлично
пара: паре
писать: писать
поместить: помещу
понятие: понятий
потенциал: потенциал
правильно: правильно
придумать: придумали
примерно: примерно
принадлежать: принадлежит
просто: просто
разрез: разрезе
ранний: раньше
робот: робот
салага: салага
сливать: сливать, сливаю
смеяться: смейтесь
собираться: собираюсь
строгий: строгих
сюда: сюда
тема: тема, теме, тему
тот: тех
уверенный: уверен
узкий: узкой
условие: условии
хабра: хабре
хабрахабра: хабрахабра
хотеть: хочу
хотя: хотя
человек: человек
читать: читает, читать
этот: эта
