amnesty: amnesty
ddos: ddos
international: international
абсолютный: абсолютная
автоматически: автоматически
акция: акциях
американский: американских
армия: армии
ассоциироваться: ассоциируется
атака: атаки
бот: боты
бригада: бригаде
буш: бушу
взрыв: взрыв
виртуальный: виртуальной
возможность: возможность
вполне: вполне
всякий: всякие
вторично: вторично
вызывать: вызывает
высказать: высказать
выстрел: выстрела
говорить: говоря
голова: голову
давать: дает
дело: деле
деятельность: деятельностью
джордж: джорджу
додумывать: додумывать
должный: должна, должны
доступный: доступной
друг: друзьям
думать: думаете
завал: завал, завале
заворот: заворот
задумать: задуманного
заключаться: заключается
запрос: запросы
злоумышленник: злоумышленники
значимость: значимость
идея: идея
интернет: интернет
использование: использование
какой: какому
кнопка: кнопку
количество: количество
конкурент: конкурентов
концепция: концепция
концлагерь: концлагерях
который: которое, которому, которых
кровь: крови
легко: легко
лежать: лежит
маскироваться: маскируясь
мир: мира, мире
момент: момент
мочь: могут
мститель: мстителей
нажать: нажав
направить: направлена, направлено
например: например
народный: народных
находиться: находится
небольшой: небольшую
немногое: немногим
необходимый: необходимое
неприятный: неприятном
нетов: нетов
новость: новость
нужный: нужный
обеспечить: обеспечить
общность: общность
объединиться: объединились
обычный: обычного
оно: оно
организация: организации
оружие: оружие, оружия
осознавать: осознающие
осознание: осознании
отвечать: отвечать
отклик: отклик
отличаться: отличается
отношение: отношение
отображать: отображает
отслеживать: отслеживает
отстраиваться: отстраиваться
ошибочный: ошибочных
падать: падает
переставать: перестает
победа: победе
победитель: победителей
побочный: побочные
повод: поводу
поддержать: поддержать
подобный: подобные
покрывать: покрывающему
получаться: получается
пользователь: пользователей, пользователь, пользователю
помочь: помочь
пора: пор
посмотреть: посмотреть
почувствовать: почувствовать
правозащитный: правозащитные
превратить: превратит
предлагаться: предлагается
привлекательность: привлекательность
привычно: привычно
приглашение: приглашение
прийти: пришло
прийтись: прийдется
присоединиться: присоединиться
причём: причем
провал: провал
прогнозировать: прогнозирует
программка: программку
пролетариат: пролетариата
проливать: проливает
простота: простота
против: против
противный: противный
пуск: пуск
пытка: пытки
радость: радость
разместить: разместить
разнести: разнесут
разослать: разослать
распространение: распространение
реализовать: реализована
реальный: реальные
рисовать: рисует
сайт: сайт, сайтов
свой: свое, свои
сей: сих
сервер: сервер, сервера
сервис: сервисы
сеть: сети
сигнал: сигнал
собственноручно: собственноручно
совершение: совершения
справедливость: справедливость
сразу: сразу
становиться: становится
старый: старой
сторона: сторона
странно: странно
также: также
такой: таких
тот: тому
тысяча: тысяч, тысячи
убеждение: убеждениям
удовольствие: удовольствием
усилить: усилят
установить: установить
участвовать: участвуют
участие: участия
участник: участников, участником
факт: факта
форма: форме
хакер: хакеров
хватать: хватает
ход: ходе
цель: целей
человек: людей, люди
широкий: широкое
шпионский: шпионское
экологический: экологические
этический: этическая
этот: эта
эффективность: эффективность
