adage: adage
advertising: advertising
age: age
clickz: clickz
com: com
crain: crain
internet: internet
june: june
rance: rance
авторитетный: авторитетных
активный: активный
баннер: баннер
бренд: брендов
взгляд: взгляд, взгляды
включая: включая
воздействие: воздействии
вопрос: вопросом
время: времени
всяческий: всяческий
далёкий: дальше
директор: директора
желание: желание
знание: знания
знать: знают
зритель: зритель
идеально: идеально
изменить: изменить
изнутри: изнутри
изучать: изучают
интеграция: интеграции
интересный: интересную
интернет: интернет
информация: информацию
источник: источников
кампания: кампании
кликнуть: кликнут
коммуникация: коммуникация
контекстный: контекстной
копирайт: копирайте
который: которое, который
краткий: краткий
креатив: креативе
креативный: креативного
культура: культуры
купить: купит
максимум: максимум
маркетинг: маркетинга, маркетинге
мегабеглый: мегабеглый
мозг: мозг
момент: момент
мощный: мощного
наблюдение: наблюдение
невозможно: невозможно
необходимость: необходимость
несколько: несколько
обзор: обзор
онлайновый: онлайновые
отсутствие: отсутствия
офлайн: оффлайн
пассивный: пассивное
писать: писать
подробно: подробно
подтверждать: подтверждает
подход: подходы
поиск: поиск, поиска
положение: положения
пользователь: пользователи
понятный: понятные
последний: последних
посыл: посыл
поэтому: поэтому
правильный: правильное, правильные
призвать: призвано
проглотить: проглотить
простой: простые
прочесть: прочесть
прятать: прятать
разрабатывать: разрабатывать
рассказ: рассказ
реклама: реклама, рекламой, рекламы
рекламист: рекламисты
рекламодатель: рекламодатели
ресурс: ресурса
связать: связано
сеть: сети
сказать: сказанное
скорее: скорее
совпасть: совпадет
создать: создать
сообщение: сообщение
стать: статей
статья: статье, статьи, статья
таргетирование: таргетирование
таргетировать: таргетированная
тема: темой, тему
тренд: тренды
уверить: уверены
узкий: узкая
указание: указанием
успех: успех
фокусировка: фокусировок
функционал: функционала
хотеться: хочется
человек: люди
эффективность: эффективность
эффективный: эффективное, эффективной
