adsense: adsense
like: like
аудитория: аудитории
бренд: бренда
вариант: вариант
введение: введение
великий: великая
вещь: вещь
возникать: возникает
вопрос: вопрос
время: время
второй: вторых
вызывать: вызывает
говорить: говорить
деньга: деньги
дешёвый: дешевле
единственно: единственно
имхо: имхо
интерес: интереса
контент: контент
контролироваться: контролируется
копейка: копейки
который: который
логика: логика
любитель: любителей
некий: некой
область: области
общий: общем
огромный: огромная
отдельный: отдельная, отдельном
откуда: откуда
первый: первых
подумать: подумал
подход: подход, подходом
показать: покажет
почему: почему
предметный: предметной
признак: признаку
сайт: сайт, сайте
сеть: сеть, сетях
скажем: скажем
случай: случае
смотреть: смотря
смущать: смущают
создавать: создавать
создание: создание
сомнительно: сомнительно
сообщество: сообщества
социальный: социальную, социальных
сразу: сразу
тема: тема
третий: третьих
туда: туда
формирование: формирование
формировать: формировать
эффект: эффект
являться: является
