банально: банально
бережно: бережно
блогер: блоггеры
будущее: будущем
весь: всем
внешний: внешние
вопрос: вопрос
вроде: вроде
вывод: выводы
выглядеть: выглядит
господин: господа, господину
делать: делать
день: день
добавить: добавить
заговорить: заговорил
ибо: ибо
изначально: изначально
иметь: иметь
интересно: интересно
интересный: интересным
какой: какие
карма: кармой
кнопка: кнопка
копировать: копировать
лично: лично
мешать: мешают
мой: моих
мочь: могу
наверняка: наверняка
надеяться: надеяться
обсуждение: обсуждение
организовать: организовать
отслеживаться: отслеживаются
отсюда: отсюда
папка: папки
персональный: персональный
повод: поводу
поздний: позже
пользователь: пользователь
попадать: попадают
почему: почему
предполагаться: предполагается
представление: представление
привет: привет
пример: пример
проект: проекту
прочитать: прочитать
работать: работает, работать
раздел: раздел
сайт: сайта
свой: свои
сделать: сделать
сервис: сервис
сказать: сказать
собраться: собрались
ссылаться: ссылаться
ссылка: ссылке, ссылки
стать: статей
статья: статьи, статью, статьями
таковой: таковые
текст: текст
тема: тему
узнать: узнать
указание: указанием
учить: учить
хабра: хабр
хотеть: хотел
хотеться: хотелось
хранить: хранить
цитировать: цитировать
