clickz: clickz
com: com
derek: derek
harding: harding
mail: mail
pull: pull
push: push
rss: rss
sourse: sourse
аудитория: аудиторий, аудиторию
безопасность: безопасности
блог: блогов
большинство: большинству
бренд: брендов
бывать: бывает
ваш: вашего
говорить: говорить
грозить: грозит
делать: делает
дерек: дерек
должный: должна
закрывать: закрывает
иначе: иначе
инбокс: инбокс
интересовать: интересует
использование: использования
использовать: использовать, используют
какой: каким
ключевой: ключевое
колонка: колонке
конкуренция: конкуренция
контекстный: контекстной
контент: контент
который: который, которым
крайне: крайне
максимально: максимально
маркетинг: маркетинг, маркетинге, маркетингу
массовый: массовом, массовые
мнение: мнению
момент: момент
наиболее: наиболее
несколько: несколько
новость: новостей
носитель: носитель
обычно: обычно
отписаться: отписаться
очередь: очередь
подкаст: подкастов
подписаться: подписаться
подписчик: подписчик
подписываться: подписываться
подходить: подходит
пока: пока
пользователь: пользователь
попадать: попадает
поток: потока, потоки
поэтому: поэтому
представитель: представители
природа: природе
причина: причин, причинам
продвижение: продвижение, продвижения
просто: просто
прочесть: прочесть
пункт: пунктов
реклама: реклама
решать: решает
сегмент: сегменты
сегодняшний: сегодняшний
серьёзный: серьезная
скорее: скорее
слово: слово
сложно: сложно
совпадать: совпадает
стать: станут
сторона: стороны
стратегия: стратегий
технология: технология
узко: узко
указывать: указывает
успешно: успешно
уступать: уступает
хардинга: хардинга
целевой: целевую
читать: читает
чтение: чтения
эффективность: эффективность
юзер: юзер, юзеры
