cnews: cnews
com: com
myspace: myspace
utherverse: utherverse
брайан: брайан
быть: будут
ввести: ввести
взрослый: взрослый, взрослых
вход: вход
год: года, лет
директор: директор
запись: запись
запретить: запрещен
исполнительный: исполнительный
источник: источник
карта: карты
клинический: клинический
компания: компания
конец: концу
кредитный: кредитной
лицо: лицам
миллион: миллиона
мой: моему
надеяться: надеется
намерить: намерена
несовершеннолетний: несовершеннолетних
новость: новость
номер: номер
обмен: обмен
оператор: оператор
открыть: открыл
отслеживать: отслеживать
повторить: повторить
подростковый: подросткового
пользователь: пользователей
потребоваться: потребуется
правило: правилах
предмет: предмет
привлечь: привлечь
профиль: профиль
прочитать: прочитал
разрешить: разрешен
регистрация: регистрации
род: рода
сайт: сайте
свой: своем, своих
сегодня: сегодня
сервис: сервиса
сетевой: сетевое
сеть: сети
случай: случай
сообщение: сообщений
сообщество: сообщества, сообщество
сотрудник: сотрудники
социальный: социальной
специальный: специальные
такой: такого, такую
успех: успех
фантазия: фантазий
шустрый: шустер
эротический: эротическими
