анонс: анонс
блог: блоге
будущее: будущем
весь: всем
видный: видна, видны
галочка: галочку
главный: главный
добиться: добиться
должный: должен, должна
заголовок: заголовок
замысел: замыслу
зарегистрировать: зарегистрированный
затем: затем
значит: значит
итак: итак
карма: карма, кармой, кармы
кнопка: кнопка
код: коду
колонка: колонку
колумнист: колумнистом
компьютер: компьютер
корректор: корректор
который: котором
машинный: машинному
написать: написать
наш: наш, нашему
новый: новые
ночью: ночью
общий: общая
отвечать: отвечает
первый: первой
повыситься: повысится
пользователь: пользователь
порог: порог
премодерация: премодерацию
прикрутить: прикрутил
программист: программист
продержаться: продержавшись
проходить: проходят
результат: результатов
сайт: сайте
самый: самый
сегодня: сегодня
сила: силой
сначала: сначала
согласно: согласно
сон: сна, сон
спать: спать
ставить: ставит
стать: стать
страница: странице
суметь: сумел
сутки: суток
текст: тексты
транслировать: транслирует
увидеть: увидел, увидеть, увидят
уйти: ушел
человек: человек, человека
четверо: четверо
читатель: читатели
