автор: автор, автора, авторами, авторов
блогер: блоггеров
валериевич: валерьевича
ввод: вводом
вещь: вещью
видеть: видит
внедрение: внедрение
внутренний: внутренняя
вовремя: вовремя
вопрос: вопрос, вопросов
вывод: выводом
выгодно: выгодно
выложить: выложил
выплачивать: выплачивая
выполняться: выполняется
генерировать: генерируемый
год: лет
дело: дело
денежка: денежка
держать: держать
деталь: деталях
доступ: доступа, доступе
журналист: журналистов
задача: задача
замысел: замыслу
зарастать: зарастает
зачётный: зачетному
знать: знаю
идеальный: идеальна, идеальную
идея: идеях
идти: шла
иметь: имеет
инструмент: инструмент, инструмента
интернет: интернет, интернете
информация: информации
искусственно: искусственно
использование: использовании, использования
использовать: использовать
картинка: картинок
качество: качестве
код: код
колонка: колонок
контент: контент, контента
концепция: концепцию
который: которую, который, которым
красивый: красивый
красота: красота, красоты
кроме: кроме
легко: легко
либо: либо
лишь: лишь
маленький: мал
малый: малая
мегабайт: мегабайты
мегабайтный: мегабайтная, мегабайтный
менее: менее
минь: мини
множество: множество
мочь: могу
напомнить: напомнило
народный: народная
настоящий: настоящая
наступить: наступил
находиться: находится
недостаток: недостатки
недра: недрах
некий: некая, некую
нереализуемый: нереализуема
несколько: несколько
несоизмеримый: несоизмеримо
никто: никто
новый: новую
обсуждение: обсуждение
общеизвестный: общеизвестны
ограниченный: ограниченную
один: одном, одну
он: нему
оплата: оплатой, оплаты
оплачивать: оплачивать
остаток: остаток
отдавать: отдаю
относительный: относительная
отсутствовать: отсутствует
отчёт: отчет
охота: охота
оценить: оценить
очень: очень
очередь: очередь
ошибаться: ошибаться
первый: первую
платёж: платежи
платёжный: платежную
побочный: побочный
подключить: подключены
познакомиться: познакомились
получение: получения
получить: получить
пользователь: пользователи, пользователя
пользоваться: пользоваться
популярный: популярными
пора: поры
почему: почему
представить: представить
приблизительно: приблизительно
придумать: придумал
применение: применения
пример: примера
принцип: принципа, принципу
провайдер: провайдера, провайдеров, провайдеры
программный: программный
продажа: продаже
проект: проекты
произвести: произвела
производить: производят
происходить: происходило
пройти: прошло
просить: прошу
просто: просто
простой: проста
работа: работы
разместить: размещенных
разный: разного
распространённость: распространенность
рассказать: рассказать
рассматриваться: рассматривалась
рассмотреть: рассмотреть
расцвет: расцвет
реальный: реальных
революция: революцию
решаться: решался
решить: решило
рядом: рядом
сам: сами
свободный: свободном
себя: собой
сегодня: сегодня
семинар: семинаров
сергей: сергея
система: систем, система, системах, систему, системы
скачать: скачайте, скачать
сложность: сложность
созреть: созрела
соответсвенный: соответсвенно
специальный: специальная
сравнение: сравнению
сразу: сразу
среди: среди
средство: средств
становиться: становится
сторона: стороны
существовать: существует
сфера: сфере, сферу
схема: схеме, схемы
считать: считать
сычёв: сычева
также: также
текст: текстов
тематический: тематических
тот: тех
точный: точного
трафик: трафик
тропа: тропа
универсальный: универсального
условие: условиях
услышать: услышал
уста: уст
утопичный: утопична
утяжеляться: утяжеляется
файл: файлов, файлу
функция: функция
хотеть: хочет, хочу
цена: ценой
ценить: ценю
цифровой: цифрового
шанс: шанс
этот: эта
эффект: эффект
