allaboutme: allaboutme
net: net
алфавитный: алфавитный
блог: блогах
ваш: ваши
весь: всем
вещь: вещь
виноватый: виновата
вопрос: вопрос
вполне: вполне
впрямую: впрямую
вроде: вроде
вывод: выводы
гадать: гадать
дело: дела
дзен: дзен
должный: должен
думать: думаешь
задать: задать
задача: задача
закинуть: закинула
знакомый: знакомым, знакомых
знать: знаешь, знаю
иметь: имеющих
имя: имена
интересный: интересные
интернет: интернета, интернете
информация: информация
исходить: исходя
какой: каким
каталог: каталогов
книга: книге
кстати: кстати
лазить: лазить
любопытство: любопытства
месяц: месяц
мой: моих
мочь: мог
наверное: наверное
наличие: наличия
например: например
наугад: наугад
неинтересный: неинтересно
новость: новости
область: области
обязательность: обязательность
опыт: опыт
ответить: ответили
отличие: отличие
отметиться: отметившись
очень: очень
побродить: побродить
поиск: поиску
полный: полного
полочка: полочкам
понажимать: понажимать
попробовать: попробовать, попробуйте
порядок: порядке
последний: последний
посмотреть: посмотреть
поудалять: поудаляв
пофантазировать: пофантазировать
появиться: появилось
предсказуемый: предсказуем
представление: представления
привлекательный: привлекательные
прикольно: прикольно
просто: просто
профессионал: профессионалами
прочитать: прочитав
работа: работы
раздел: разделам
разложить: разложена
раскладывание: раскладыванию
реализовать: реализуема
результат: результат
сайт: сайтов
сделать: сделать
сегодня: сегодня
склонность: склонность
скрываться: скрывается
слишком: слишком
смысл: смысл
спам: спам
список: списка, списке, списку, список
спрашивать: спрашивайте
стих: стихов
страница: страницам
странный: странная
судьба: судьба
сутки: сутки
также: также
такой: такая, такого, такому
технически: технически
ткнуть: ткнуть
уверенно: уверенно
укладываться: укладывается
упорядочивание: упорядочиванию
хотя: хотя
час: час
человеческий: человеческая
являться: являющихся
яндекс: яндекса
ящик: ящиков
