clx: clx
emarka: emarka
target: target
www: www
активно: активно
аудитория: аудитории
баннер: баннеров
бизнес: бизнес
буклет: буклет
быстро: быстро
веб: веб
вопрос: вопросах, вопросы
впервые: впервые
всероссийский: всероссийской
выходить: выходят
генеральный: генеральный
год: лет
грамотно: грамотно
деятельность: деятельности
директор: директор
дмитрий: дмитрий
другой: другие
запрос: запросам
затрата: затраты
знание: знания
инвестиция: инвестиций
инструмент: инструмент, инструментами
интернет: интернет, интернете
использовать: используя
кампания: кампания
киб: киб
ключевой: ключевых
комментировать: комментирует
компания: компании
кулина: кулин
кушнер: кушнеров
леонид: леонид
лидерский: лидерские
маркетинг: маркетинг, маркетинге, маркетингу
менеджер: менеджер
мероприятие: мероприятие, мероприятиями
мнение: мнению
мой: моему
назад: назад
незаметно: незаметно
несколько: несколько
никита: никите
объём: объемы
огромный: огромными
один: одним
однако: однако
организовать: организовано
отбивать: отбивающий
ответить: ответят
отдельный: отдельное
оценка: оценка
очень: очень
партнёрский: партнерский
первый: первые
план: план, планах
повысить: повысить
поддержка: поддержку
подобный: подобной
поисковый: поисковое, поисковый, поисковых
получить: получить
пользоваться: пользоваться
попасть: попасть
популярный: популярным
постоянный: постоянной
преподаватель: преподаватели
проведение: проведение
провести: проведут
проводиться: проводится
прогресс: прогресс
продажа: продажи
продвижение: продвижение
проект: проекта, проекты
профессиональный: профессиональные
пятидневный: пятидневный
работать: работающие, работающий
разработка: разработку
рассказать: рассказать
рассчитать: рассчитать
расти: растет, растут
реальный: реальные
резюмировать: резюмирует
реклама: реклама, рекламы
рекламный: рекламная, рекламную, рекламных
риф: риф
рудняев: рудняев
румянцев: румянцев
рынок: рынка
сайт: сайт
свой: свое, свои
сделать: сделать
сегмент: сегмент
семинар: семинар, семинара, семинарах
сентябрь: сентября
сергей: сергей
система: систем
скорее: скорее
скоро: скоро
собираться: собираюсь
создание: создание
специалист: специалисты
среди: среди
стать: станет
сфера: сфере
также: также
такой: таких
тематика: тематики
темп: темпами
технический: техническую
тусовочный: тусовочными
удержание: удержания
участие: участие
филипп: филипп
чистовый: чистов
чётко: четко
электронный: электронный
юрий: юрий
являться: являются
