автоматически: автоматически
быть: будут
ваш: ваши
вероятность: вероятность
вид: виде
второй: вторых
выводить: выводить
выглядеть: выглядеть
геометрически: геометрически
делать: делать
добавиться: добавился
добавление: добавления
добавляться: добавляться
должный: должно
другой: другому
замечательный: замечательное
идея: идея
именно: именно
иначе: иначе
использование: использование
комфортный: комфортные
который: которые
место: месте
минимум: минимум
момент: моментом
набрать: набрать
нажатие: нажатии
нажать: нажал
находиться: находится
нежели: нежели
нужный: нужен
обеспечить: обеспечит
облако: облако
область: область
один: одно
оно: оно
очень: очень
первый: первых
подумать: подумают
показывать: показывать
поле: полем
пользователь: пользователю, пользователя
популярный: популярные
почему: почему
придерживаться: придерживаясь
пример: примеры
присутсвовать: присутсвуют
причём: причем
пройти: пройдет
просто: просто
путаться: путаться
размещать: размещаю
редактирование: редактирования
рядом: рядом
самый: самые, самым
сообщение: сообщение
специалист: специалисты
ссылка: ссылок
таг: таги
туда: туда
тэг: тэг, тэгов
удобно: удобно
условие: условия
форма: формой
функциональность: функциональность
хабратред: хабратред
это: этим
являться: является
