ehouse: ehouse
активно: активно
буквально: буквально
владислав: владислава
войти: вошел
время: время
группа: группу
гугл: гугле
директор: директора
дорого: дорого
другой: других
интернет: интернет
искать: искать
использовать: использует
источник: источник
итак: итак
каждый: каждого, каждый
камень: камней
кликать: кликают
который: которые, который
магазин: магазины
маркет: маркета, маркетом
насколько: насколько
несколько: несколько
никакой: никаких
нужно: нужно
оживить: оживить
остальной: остальные
ответ: ответ
ответить: ответил
плачевный: плачевный
поисковик: поисковиках, поисковиков
покупатель: покупателей
получать: получаем
посетитель: посетителя
почему: почему
правый: правы
практически: практически
причина: причин
пробовать: пробовали
просто: просто
простой: прост
публиковать: публикую
работа: работы
реальный: реальных
результат: результат
реклама: реклама, рекламы
рекламироваться: рекламироваться, рекламируемся
робот: роботов
сидеть: сидят
спросить: спросил
ссылка: ссылке
считать: считать
также: также
точность: точностью
трафик: трафик, трафике
уметь: умеем, умею
утверждение: утверждение
участвовать: участвует
холдинг: холдинга
цент: цента
эффективно: эффективно
эффективность: эффективность
эффективный: эффективна
яндекс: яндекс, яндексе
