imho: imho
pookies: pookies
адекватный: адекватное
альтернативный: альтернативным
браузер: браузерах
вебстраничка: вебстраничек
вещь: вещей, вещь
возникать: возникает
вопрос: вопроса
время: времени, время
говорить: говоря
голова: голове
группа: группу
давно: давно
друг: друзей
другой: другое
знакомый: знакомых
идти: идет
измерить: измерить
иметь: имеет, имеющих
интересно: интересно
интересовать: интересует
интересоваться: интересовался
интернет: интернет, интернета, интернете
казаться: кажется
какой: каким, какую
карта: карту
картинка: картинка
кой: коем
количество: количество
который: который
красивый: красивая
мертворождённый: мертворожденная
минимум: минимум
найти: найти
например: например
нарисовать: нарисовать
начать: начать
начинать: начинать
негатив: негатива
некоторый: некоторое
несколько: несколько
никто: никто
образ: образ
опыт: опыт
организовать: организовать
оружие: оружие
очень: очень
ощущение: ощущение, ощущения
перемещение: перемещение
плоскость: плоскость
подумать: подумать
попытка: попытки, попыток
потратить: потратить
поэтому: поэтому
представление: представление
представлять: представляем
просмотр: просмотра
пук: пуках
работа: работы
разный: разное
ракета: ракету
ранний: раньше
речь: речь
решить: решил
свой: своими
сеть: сети
сказать: сказать
случай: случае
способ: способом
спросить: спросить
сравнить: сравнить
старт: старт
странный: странная, странных
структура: структура
также: также
таки: таки
такой: такая, такие
тема: темой
трёхмерный: трехмерная, трехмерных
форма: форме, форму
хороший: хороший
хотеть: хотел, хочу
хотеться: хочется
цеплять: цепляет
честно: честно
шар: шар
