advertising: advertising
alexa: alexa
america: america
blog: blog
branded: branded
burns: burns
casino: casino
clickz: clickz
com: com
crowd: crowd
date: date
dating: dating
dream: dream
enid: enid
entertainment: entertainment
eons: eons
gofish: gofish
harras: harras
hyatt: hyatt
jet: jet
kate: kate
kaye: kaye
kingdon: kingdon
las: las
launches: launches
liberty: liberty
mark: mark
monster: monster
mutual: mutual
networking: networking
quick: quick
resort: resort
set: set
show: show
social: social
sourse: sourse
tutorial: tutorial
vegas: vegas
verizon: verizon
youttube: youttube
youtube: youtube
аккаунт: аккаунты
аккуатный: аккуатно
американский: американские, американских
база: базу
баннер: баннеры
баннерный: баннерные
беглый: беглый
бесплатный: бесплатный
бесполезно: бесполезно
благополучие: благополучие
благополучный: благополучных
блог: блогах, блогов
блогосфера: блогосфера, блогосферой
бренд: брендов
брендирование: брендировании
будущий: будущих
быть: буду, будут
взамен: взамен
вид: вид
видеосюжет: видеосюжет
вирусный: вирусный
вместе: вместе
внутри: внутри
возможность: возможность
воплощение: воплощении
восхищаться: восхищается
время: время
выбирать: выбирать
выбрать: выбрать
главный: главные
говорить: говорят
голосование: голосованием
голосовать: голосуют
данные: данным
девушка: девушек
дело: дела
джефф: джефф
желать: желающий
жизнь: жизнь
жительство: жительства
завести: завести
задача: задача
замечательный: замечательно
занимать: занимает
запускать: запускает
идти: идут
известный: известные
издание: изданиях
иллюстрация: иллюстрация
интерактивный: интерактивное
интерес: интересов, интересы
интернет: интернете
исключать: исключают
использовать: использовать
каждый: каждый
кастинг: кастинга
качество: качестве
клип: клипы
количество: количестве
колонка: колонке
контекстный: контекстное
контент: контент
короткий: короткий
красота: красотой
кроме: кроме
кто: кого, кому
лишь: лишь
любовь: любовь
любой: любого
майами: майами
маркетолог: маркетологи
менять: меняют
местный: местных
место: места, место
мечта: мечта
момент: момента
монстр: монстров
напиток: напиток
направлять: направляющие
например: например
находиться: находится
начинаться: начинается
недавно: недавно
некролог: некрологов
необходимо: необходимо
неограниченный: неограниченном
нужно: нужно
обзор: обзор
один: одна
описывать: описывать
основатель: основатель
остальной: остальном
остаться: останется
осуществить: осуществить
париж: париж
партнёр: партнеров
пенсионер: пенсионеров, пенсионеры
переехать: переехать
печатный: печатных
пиар: пиар
планета: планете
площадка: площадки
победитель: победители
повторять: повторяет
подобный: подобные
подробно: подробно
подходить: подходит
полететь: полетят
полный: полную
получать: получает
помогать: помогает
популярный: популярных
поскольку: поскольку
правильно: правильно
правильный: правильные
практический: практическом
предлагаться: предлагаются
предполагаться: предполагается, предполагалось
привлечь: привлекла
присылать: присылает, присылать
продвигать: продвигать
продвижение: продвижения
проект: проект, проекта
прочитать: прочитанного
путешествовать: путешествуют
развитие: развития
размещение: размещение
реклама: рекламы
рекламодатель: рекламодателей, рекламодателями
ролик: ролики
самый: самое, самую, самых
свой: свои, своих
сентябрь: сентябре
сеть: сеть, сетях
собираться: собирается
собрать: собрать
совпадение: совпадении
создавать: создавая
сообщество: сообществ, сообщества
социально: социально
социальный: социальная, социальную, социальных
социум: социум
спонсор: спонсор
стадия: стадии
стандартный: стандартные
старикан: стариканов
стать: станет, станут
статья: статью
стратегически: стратегически
стремиться: стремиться
строить: строить
сфокусировать: сфокусированное
считать: считает, считают
также: также
талант: талантом
таргетировать: таргетировать
тот: тех
трафик: трафику
трендсеттер: трендсеттеров
узко: узко
умно: умно
участник: участников
финансы: финансы
френд: френдами
хотеть: хочет
часто: часто
человек: человек
число: числе
чужой: чужих
энергетический: энергетическим
этот: этих
юзер: юзеры
