блог: блоги
вероятно: вероятно
второй: вторых
далее: далее
интересно: интересно
какой: какие, каких
категория: категориям
многий: многим
мы: нам
некий: некий
нужно: нужно
первый: первых
планировать: планируем
пользователь: пользователи
пользовательский: пользовательские, пользовательских
предлагать: предлагайте
предпочтение: предпочтений
расширить: расширен
рейтинг: рейтинг
сайт: сайта, сайтов
сбор: сбора
сеть: сети, сетях
состоять: состоят
социальный: социальные
список: список
спрашивать: спрашивать
статистика: статистики
строить: строить
транслировать: транслировать
три: трем
узнать: узнать
частый: чаще
читать: читают
