балл: балл, баллов
блог: блог
важно: важно
важный: важнее, важны
везде: везде
величина: величину
влиять: влияет
внимание: внимание
высокий: высоким
голос: голос
группа: группы
довольно: довольно
должный: должны
единица: единицу
зависимый: зависим
игорь: игорю
идеал: идеале
идеальный: идеальный
изменить: изменить
казаться: кажется
количество: количества, количество
комментарий: комментариев, комментарий, комментария
который: которую, которые
коэффициент: коэффициент
логично: логично
логичный: логичным
менее: менее
метод: методы
многочислить: многочислены
наверное: наверное
написать: написать
например: например
насколько: насколько
некий: некий
немного: немного
нравиться: нравятся
нужно: нужно
образ: образом
обратить: обратили
описать: описать
оправдать: оправдала
опускать: опускать
оценка: оценки, оценкой
очевидный: очевидным
повторять: повторяю
поднимать: поднимать
поднять: поднять
подняться: подняться
подсчёт: подсчете
пользователь: пользователь
понимать: понимаю
понятно: понятно
пост: постов, посты
практика: практику
проблема: проблемой
простой: просты
работать: работает
разобраться: разобраться
рейтинг: рейтинг, рейтингов, рейтингом
рейтинговый: рейтинговая
сайт: сайте
самый: самые
сбк: сбк
сверхпопулярный: сверхпопулярный
сделать: сделать
сильно: сильно
система: система
спорный: спорно
способ: способ
средний: средний
считать: считать
считаться: считающийся
такой: таким
товарищ: товарища
топ: топ
увеличиваться: увеличивается
увеличить: увеличить
уменьшаться: уменьшается
уменьшить: уменьшить
учитываться: учитывается, учитываться
человек: людей, человека
шаг: шагом
явно: явно
явный: явные
